10
10
"^""""""""
"^""""""""
""^"""""""
""^"""""""
"^~~~^""""
^"""~~~""^
"""""""~^"
"""""""^""
"""""""^""
""""""^"""